111111111111111
11E10000C000CP1
111111111111111